#..###
#.##.#####
#....###.#
#.........#
#####....#
###..###..#
..#@.#....#
.##.##.####
.#.....###
.#.....##
.#######